R 720         480

NO textures/brick.xpm
SO textures/blue.xpm
WE textures/banner.xpm
EA textures/hitler.xpm

F 112,112,112
C 107,0,213


        111111111111111111
        1000000000110000011111111
        1011000001110000000000001
        1000000000000000000001111
111111111011000001110000000000001
100000000011000001110111111111111
11110111111111011100000010001
11110111111111011101010010001
11000000110101011100000010001
1000000000000W001100000010001
10000000000000001101010010001
11000001110101011111011110001
11110111 1000101 111111010001
11110111 1111111 111111111111
11110111
10000001
11111111