


NO textures/brick.xpm
SO textures/blue.xpm
WE textures/banner.xpm
EA textures/hitler.xpm




F 112,112,112
C 107,0,213

11111
1E001
10001
11111