R 720 480
NO textures/trump_china.xpm
SO textures/taiwan.xpm
WE textures/winnie.xpm
EA textures/china_asshole.xpm

F 113,112,112
C 107,0,254

    111111111111111111
    100000011000000001
1111100000000000000001
1000000011111111111111
100100001111111111
10000000E000000001
100000010000000001
100000000000000001
100000000000000001
111111111111111111